000:         >>v#    
001:         .#v.    
002:         #.v.    
003:         ..v.    
004: ...#...v..v#    
005: >>>v...>#.>>    
006: ..#v...#....    
007: ...>>>>v..#.    
008:         ...#....
009:         .....#..
010:         .#......
011:         ......#.
